001700509573024106800501002700295018009400305652800007465080071000159004908007053
029650178705180600100900500257800309600219005900007046573400021800020453010395000
008203500009670408346050702430010059967005001000496203280034067703500904004107020
800005216045862007670009500769204030020001765001670009004096800907400601306107940
700020548052008000430957106900061700041030695307509001083075469200080350074306000
705002030230100056090536720406081205809004000300095648040053180523000069001429003
740680900060100080012054736307800120008401570490720060209500040500069308106047205
460020905920145680005300004008964302200500800356200490090070003630850710017609208
437205610082060050000301028091807000703950186040006207200798045004003072379002060
002905047507023006036010950610204008005800004048590213200300701870002039069147020
920870605084036079006001008510709020300012087402300960007253100005048702231000804
062100950908035006040029170250000084400502600890463205020357000070006502685004731
001700905305098024690015007908350012400900536032046000089003040203801650050029073
203070016100026704706480030001800490094710062320094080600003005902157048405060903
486051230002070004005840109000568090904000700368094512009130028003085970817600040
902500607003840090014760302601005000000100264237684509306420900000006023429071806
571390240300850009080010035043205001260041750005600820004123500152008096007009410
806047003901083547300900600680090300012376084009800706290760031003502060108400270
508900216090168045406200000360500801829017530000039600705486120040050360680001007
056120400100030906308760105700000000084371692061095078870903204000607800613040709