096040001100060004504810390007950043030080000405023018010630059059070830003590007
105802000090076405200400819019007306762083090000061050007600030430020501600308900
005030081902850060600004050007402830349760005008300490150087002090000600026049503
340910020096080041008020070060057039102060700970030064450208006080090050603001890
007300405000020900253064870090740360000030080836209047100802603600000018082610004
935007008000308070600500490073004000400175080061800247018700000006080750750403862
005020001087350046400060500050900000070035410693140857741500608000284005500000304
007500030800230009034790860003004198048150003006023007351060780400310006070005002
058004021060853007039020005800001006003700210106082500670200180900400050080916702
020100006530082940800340005354276100006030004900001620090003078743809000005004301
093200080200085000080730254975800031000074060604503807700002048320400070008057900
086702004000500800154090237070905001029004008510600042205070083000153000390008075
070000280020006057865472900009250064040019070708004009300700698007901000590028030
002130748804000002017802600068090270093200004500460300009024003006300190385001020
904603001370100206006009304001300905560091000820004610007900040405016700102007508
469507000038094500000030489300061940080470002701000800010050090850003601290608750
009201070070000002542083109790025006000030907803600200017060495980500003400917020
071003005630501907090670031760020040500960178010030002056019280000006500042300010
814500602007942580000100300000070000286400730470089250150024963000603000302800005
006200030070000160410657080062900301004002500190065840000530027720080050309026408